"filename", "language", "Markdown", "XML", "Java", "CSS", "comment", "blank", "total"
"f:\2Study\2Nam2\CS\OOP\Bomberman\bomber10\.idea\libraries\lib.xml", "XML", 0, 10, 0, 0, 0, 0, 10
"f:\2Study\2Nam2\CS\OOP\Bomberman\bomber10\.idea\misc.xml", "XML", 0, 6, 0, 0, 0, 0, 6
"f:\2Study\2Nam2\CS\OOP\Bomberman\bomber10\.idea\modules.xml", "XML", 0, 8, 0, 0, 0, 0, 8
"f:\2Study\2Nam2\CS\OOP\Bomberman\bomber10\.idea\runConfigurations.xml", "XML", 0, 10, 0, 0, 0, 0, 10
"f:\2Study\2Nam2\CS\OOP\Bomberman\bomber10\.idea\uiDesigner.xml", "XML", 0, 124, 0, 0, 0, 0, 124
"f:\2Study\2Nam2\CS\OOP\Bomberman\bomber10\.idea\vcs.xml", "XML", 0, 6, 0, 0, 0, 0, 6
"f:\2Study\2Nam2\CS\OOP\Bomberman\bomber10\README.md", "Markdown", 10, 0, 0, 0, 0, 9, 19
"f:\2Study\2Nam2\CS\OOP\Bomberman\bomber10\bin\.VSCodeCounter\2021-12-10_18-36-14\details.md", "Markdown", 101, 0, 0, 0, 0, 6, 107
"f:\2Study\2Nam2\CS\OOP\Bomberman\bomber10\bin\.VSCodeCounter\2021-12-10_18-36-14\results.md", "Markdown", 52, 0, 0, 0, 0, 7, 59
"f:\2Study\2Nam2\CS\OOP\Bomberman\bomber10\bin\.idea\libraries\lib.xml", "XML", 0, 10, 0, 0, 0, 0, 10
"f:\2Study\2Nam2\CS\OOP\Bomberman\bomber10\bin\.idea\misc.xml", "XML", 0, 6, 0, 0, 0, 0, 6
"f:\2Study\2Nam2\CS\OOP\Bomberman\bomber10\bin\.idea\modules.xml", "XML", 0, 8, 0, 0, 0, 0, 8
"f:\2Study\2Nam2\CS\OOP\Bomberman\bomber10\bin\.idea\runConfigurations.xml", "XML", 0, 10, 0, 0, 0, 0, 10
"f:\2Study\2Nam2\CS\OOP\Bomberman\bomber10\bin\.idea\uiDesigner.xml", "XML", 0, 124, 0, 0, 0, 0, 124
"f:\2Study\2Nam2\CS\OOP\Bomberman\bomber10\bin\.idea\vcs.xml", "XML", 0, 6, 0, 0, 0, 0, 6
"f:\2Study\2Nam2\CS\OOP\Bomberman\bomber10\bin\README.md", "Markdown", 10, 0, 0, 0, 0, 9, 19
"f:\2Study\2Nam2\CS\OOP\Bomberman\bomber10\bin\bomber10.iml", "XML", 0, 12, 0, 0, 0, 0, 12
"f:\2Study\2Nam2\CS\OOP\Bomberman\bomber10\bin\src\Bomberman.class", "Java", 0, 0, 20, 0, 0, 0, 20
"f:\2Study\2Nam2\CS\OOP\Bomberman\bomber10\bin\src\bomb\Bomb.class", "Java", 0, 0, 72, 0, 65, 0, 137
"f:\2Study\2Nam2\CS\OOP\Bomberman\bomber10\bin\src\entities\Bomber.class", "Java", 0, 0, 61, 0, 0, 3, 64
"f:\2Study\2Nam2\CS\OOP\Bomberman\bomber10\bin\src\entities\Entity.class", "Java", 0, 0, 48, 0, 0, 0, 48
"f:\2Study\2Nam2\CS\OOP\Bomberman\bomber10\bin\src\entities\enemy\Balloom.class", "Java", 0, 0, 19, 0, 0, 0, 19
"f:\2Study\2Nam2\CS\OOP\Bomberman\bomber10\bin\src\entities\enemy\EnemyManager.class", "Java", 0, 0, 24, 0, 0, 0, 24
"f:\2Study\2Nam2\CS\OOP\Bomberman\bomber10\bin\src\entities\enemy\Oneal.class", "Java", 0, 0, 16, 0, 0, 0, 16
"f:\2Study\2Nam2\CS\OOP\Bomberman\bomber10\bin\src\game\LEVEL.class", "Java", 0, 0, 14, 0, 3, 0, 17
"f:\2Study\2Nam2\CS\OOP\Bomberman\bomber10\bin\src\graphics\Sprite.class", "Java", 0, 0, 88, 0, 0, 0, 88
"f:\2Study\2Nam2\CS\OOP\Bomberman\bomber10\bin\src\graphics\SpriteSheet.class", "Java", 0, 0, 15, 0, 2, 1, 18
"f:\2Study\2Nam2\CS\OOP\Bomberman\bomber10\bin\src\gui\game\AssetSetter.class", "Java", 0, 0, 34, 0, 0, 0, 34
"f:\2Study\2Nam2\CS\OOP\Bomberman\bomber10\bin\src\gui\game\CollisionChecker.class", "Java", 0, 0, 136, 0, 0, 0, 136
"f:\2Study\2Nam2\CS\OOP\Bomberman\bomber10\bin\src\gui\game\GamePane$1.class", "Java", 0, 0, 18, 0, 0, 0, 18
"f:\2Study\2Nam2\CS\OOP\Bomberman\bomber10\bin\src\gui\game\GamePane.class", "Java", 0, 0, 145, 0, 0, 1, 146
"f:\2Study\2Nam2\CS\OOP\Bomberman\bomber10\bin\src\gui\game\GetImage.class", "Java", 0, 0, 35, 0, 1, 0, 36
"f:\2Study\2Nam2\CS\OOP\Bomberman\bomber10\bin\src\gui\game\KeyHandler$1.class", "Java", 0, 0, 21, 0, 0, 0, 21
"f:\2Study\2Nam2\CS\OOP\Bomberman\bomber10\bin\src\gui\game\KeyHandler$2.class", "Java", 0, 0, 19, 0, 0, 0, 19
"f:\2Study\2Nam2\CS\OOP\Bomberman\bomber10\bin\src\gui\game\KeyHandler.class", "Java", 0, 0, 14, 0, 0, 0, 14
"f:\2Study\2Nam2\CS\OOP\Bomberman\bomber10\bin\src\gui\game\UI.class", "Java", 0, 0, 50, 0, 0, 1, 51
"f:\2Study\2Nam2\CS\OOP\Bomberman\bomber10\bin\src\gui\model\GameButton.class", "Java", 0, 0, 20, 0, 0, 0, 20
"f:\2Study\2Nam2\CS\OOP\Bomberman\bomber10\bin\src\gui\model\GameLabel.class", "Java", 0, 0, 14, 0, 0, 0, 14
"f:\2Study\2Nam2\CS\OOP\Bomberman\bomber10\bin\src\gui\model\GameSubScene.class", "Java", 0, 0, 33, 0, 0, 0, 33
"f:\2Study\2Nam2\CS\OOP\Bomberman\bomber10\bin\src\gui\scenes\level1\Level1.class", "Java", 0, 0, 5, 0, 0, 0, 5
"f:\2Study\2Nam2\CS\OOP\Bomberman\bomber10\bin\src\gui\scenes\level1\level1_map.fxml", "XML", 0, 84, 0, 0, 0, 3, 87
"f:\2Study\2Nam2\CS\OOP\Bomberman\bomber10\bin\src\gui\scenes\loading\loading.fxml", "XML", 0, 20, 0, 0, 0, 3, 23
"f:\2Study\2Nam2\CS\OOP\Bomberman\bomber10\bin\src\gui\scenes\loading\loadingController.class", "Java", 0, 0, 23, 0, 0, 0, 23
"f:\2Study\2Nam2\CS\OOP\Bomberman\bomber10\bin\src\gui\scenes\menu\menu.fxml", "XML", 0, 96, 0, 0, 0, 3, 99
"f:\2Study\2Nam2\CS\OOP\Bomberman\bomber10\bin\src\gui\scenes\menu\menuController.class", "Java", 0, 0, 44, 0, 0, 0, 44
"f:\2Study\2Nam2\CS\OOP\Bomberman\bomber10\bin\src\gui\scenes\scenes.css", "CSS", 0, 0, 0, 53, 2, 14, 69
"f:\2Study\2Nam2\CS\OOP\Bomberman\bomber10\bin\src\object\Bombs.class", "Java", 0, 0, 10, 0, 0, 0, 10
"f:\2Study\2Nam2\CS\OOP\Bomberman\bomber10\bin\src\object\Flames.class", "Java", 0, 0, 8, 0, 0, 0, 8
"f:\2Study\2Nam2\CS\OOP\Bomberman\bomber10\bin\src\object\ObjectManager.class", "Java", 0, 0, 16, 0, 3, 0, 19
"f:\2Study\2Nam2\CS\OOP\Bomberman\bomber10\bin\src\object\Portal.class", "Java", 0, 0, 7, 0, 0, 0, 7
"f:\2Study\2Nam2\CS\OOP\Bomberman\bomber10\bin\src\object\Speed.class", "Java", 0, 0, 10, 0, 0, 0, 10
"f:\2Study\2Nam2\CS\OOP\Bomberman\bomber10\bin\src\tile\Brick.class", "Java", 0, 0, 25, 0, 0, 0, 25
"f:\2Study\2Nam2\CS\OOP\Bomberman\bomber10\bin\src\tile\Grass.class", "Java", 0, 0, 12, 0, 0, 0, 12
"f:\2Study\2Nam2\CS\OOP\Bomberman\bomber10\bin\src\tile\Tile.class", "Java", 0, 0, 19, 0, 0, 0, 19
"f:\2Study\2Nam2\CS\OOP\Bomberman\bomber10\bin\src\tile\TileManager.class", "Java", 0, 0, 34, 0, 0, 1, 35
"f:\2Study\2Nam2\CS\OOP\Bomberman\bomber10\bin\src\tile\Wall.class", "Java", 0, 0, 17, 0, 0, 0, 17
"f:\2Study\2Nam2\CS\OOP\Bomberman\bomber10\bomber10.iml", "XML", 0, 12, 0, 0, 0, 0, 12
"f:\2Study\2Nam2\CS\OOP\Bomberman\bomber10\src\Bomberman.java", "Java", 0, 0, 25, 0, 5, 9, 39
"f:\2Study\2Nam2\CS\OOP\Bomberman\bomber10\src\bomb\Bomb.java", "Java", 0, 0, 269, 0, 22, 32, 323
"f:\2Study\2Nam2\CS\OOP\Bomberman\bomber10\src\entities\Bomber.java", "Java", 0, 0, 246, 0, 38, 31, 315
"f:\2Study\2Nam2\CS\OOP\Bomberman\bomber10\src\entities\Entity.java", "Java", 0, 0, 101, 0, 9, 19, 129
"f:\2Study\2Nam2\CS\OOP\Bomberman\bomber10\src\entities\enemy\Balloom.java", "Java", 0, 0, 53, 0, 0, 13, 66
"f:\2Study\2Nam2\CS\OOP\Bomberman\bomber10\src\entities\enemy\EnemyManager.java", "Java", 0, 0, 56, 0, 1, 11, 68
"f:\2Study\2Nam2\CS\OOP\Bomberman\bomber10\src\entities\enemy\Oneal.java", "Java", 0, 0, 63, 0, 0, 14, 77
"f:\2Study\2Nam2\CS\OOP\Bomberman\bomber10\src\game\LEVEL.java", "Java", 0, 0, 32, 0, 0, 11, 43
"f:\2Study\2Nam2\CS\OOP\Bomberman\bomber10\src\graphics\Sprite.java", "Java", 0, 0, 189, 0, 46, 55, 290
"f:\2Study\2Nam2\CS\OOP\Bomberman\bomber10\src\graphics\SpriteSheet.java", "Java", 0, 0, 30, 0, 6, 7, 43
"f:\2Study\2Nam2\CS\OOP\Bomberman\bomber10\src\gui\game\AssetSetter.java", "Java", 0, 0, 41, 0, 27, 9, 77
"f:\2Study\2Nam2\CS\OOP\Bomberman\bomber10\src\gui\game\CollisionChecker.java", "Java", 0, 0, 278, 0, 20, 55, 353
"f:\2Study\2Nam2\CS\OOP\Bomberman\bomber10\src\gui\game\GamePane.java", "Java", 0, 0, 220, 0, 53, 52, 325
"f:\2Study\2Nam2\CS\OOP\Bomberman\bomber10\src\gui\game\GetImage.java", "Java", 0, 0, 100, 0, 16, 17, 133
"f:\2Study\2Nam2\CS\OOP\Bomberman\bomber10\src\gui\game\KeyHandler.java", "Java", 0, 0, 52, 0, 0, 7, 59
"f:\2Study\2Nam2\CS\OOP\Bomberman\bomber10\src\gui\game\UI.java", "Java", 0, 0, 81, 0, 7, 20, 108
"f:\2Study\2Nam2\CS\OOP\Bomberman\bomber10\src\gui\model\GameButton.java", "Java", 0, 0, 19, 0, 2, 5, 26
"f:\2Study\2Nam2\CS\OOP\Bomberman\bomber10\src\gui\model\GameLabel.java", "Java", 0, 0, 12, 0, 0, 4, 16
"f:\2Study\2Nam2\CS\OOP\Bomberman\bomber10\src\gui\model\GameSubScene.java", "Java", 0, 0, 39, 0, 2, 11, 52
"f:\2Study\2Nam2\CS\OOP\Bomberman\bomber10\src\gui\scenes\level1\Level1.java", "Java", 0, 0, 3, 0, 0, 3, 6
"f:\2Study\2Nam2\CS\OOP\Bomberman\bomber10\src\gui\scenes\level1\level1Controller.java", "Java", 0, 0, 0, 0, 77, 18, 95
"f:\2Study\2Nam2\CS\OOP\Bomberman\bomber10\src\gui\scenes\level1\level1_map.fxml", "XML", 0, 84, 0, 0, 0, 3, 87
"f:\2Study\2Nam2\CS\OOP\Bomberman\bomber10\src\gui\scenes\loading\loading.fxml", "XML", 0, 20, 0, 0, 0, 3, 23
"f:\2Study\2Nam2\CS\OOP\Bomberman\bomber10\src\gui\scenes\loading\loadingController.java", "Java", 0, 0, 38, 0, 2, 9, 49
"f:\2Study\2Nam2\CS\OOP\Bomberman\bomber10\src\gui\scenes\menu\menu.fxml", "XML", 0, 96, 0, 0, 0, 3, 99
"f:\2Study\2Nam2\CS\OOP\Bomberman\bomber10\src\gui\scenes\menu\menuController.java", "Java", 0, 0, 72, 0, 9, 19, 100
"f:\2Study\2Nam2\CS\OOP\Bomberman\bomber10\src\gui\scenes\scenes.css", "CSS", 0, 0, 0, 53, 2, 14, 69
"f:\2Study\2Nam2\CS\OOP\Bomberman\bomber10\src\object\Bombs.java", "Java", 0, 0, 14, 0, 0, 4, 18
"f:\2Study\2Nam2\CS\OOP\Bomberman\bomber10\src\object\Flames.java", "Java", 0, 0, 14, 0, 0, 3, 17
"f:\2Study\2Nam2\CS\OOP\Bomberman\bomber10\src\object\ObjectManager.java", "Java", 0, 0, 59, 0, 7, 10, 76
"f:\2Study\2Nam2\CS\OOP\Bomberman\bomber10\src\object\Portal.java", "Java", 0, 0, 15, 0, 0, 4, 19
"f:\2Study\2Nam2\CS\OOP\Bomberman\bomber10\src\object\Speed.java", "Java", 0, 0, 14, 0, 0, 4, 18
"f:\2Study\2Nam2\CS\OOP\Bomberman\bomber10\src\tile\Brick.java", "Java", 0, 0, 52, 0, 14, 10, 76
"f:\2Study\2Nam2\CS\OOP\Bomberman\bomber10\src\tile\Grass.java", "Java", 0, 0, 9, 0, 3, 7, 19
"f:\2Study\2Nam2\CS\OOP\Bomberman\bomber10\src\tile\Tile.java", "Java", 0, 0, 27, 0, 2, 12, 41
"f:\2Study\2Nam2\CS\OOP\Bomberman\bomber10\src\tile\TileManager.java", "Java", 0, 0, 82, 0, 7, 13, 102
"f:\2Study\2Nam2\CS\OOP\Bomberman\bomber10\src\tile\Wall.java", "Java", 0, 0, 11, 0, 3, 7, 21
"Total", "-", 173, 752, 3462, 106, 456, 589, 5538