"filename", "language", "Markdown", "XML", "Java", "CSS", "comment", "blank", "total"
"f:\2Study\2Nam2\CS\OOP\Bomberman\bomber10\.idea\libraries\lib.xml", "XML", 0, 10, 0, 0, 0, 0, 10
"f:\2Study\2Nam2\CS\OOP\Bomberman\bomber10\.idea\misc.xml", "XML", 0, 6, 0, 0, 0, 0, 6
"f:\2Study\2Nam2\CS\OOP\Bomberman\bomber10\.idea\modules.xml", "XML", 0, 8, 0, 0, 0, 0, 8
"f:\2Study\2Nam2\CS\OOP\Bomberman\bomber10\.idea\runConfigurations.xml", "XML", 0, 10, 0, 0, 0, 0, 10
"f:\2Study\2Nam2\CS\OOP\Bomberman\bomber10\.idea\uiDesigner.xml", "XML", 0, 124, 0, 0, 0, 0, 124
"f:\2Study\2Nam2\CS\OOP\Bomberman\bomber10\.idea\vcs.xml", "XML", 0, 6, 0, 0, 0, 0, 6
"f:\2Study\2Nam2\CS\OOP\Bomberman\bomber10\README.md", "Markdown", 10, 0, 0, 0, 0, 9, 19
"f:\2Study\2Nam2\CS\OOP\Bomberman\bomber10\bin\.idea\libraries\lib.xml", "XML", 0, 10, 0, 0, 0, 0, 10
"f:\2Study\2Nam2\CS\OOP\Bomberman\bomber10\bin\.idea\misc.xml", "XML", 0, 6, 0, 0, 0, 0, 6
"f:\2Study\2Nam2\CS\OOP\Bomberman\bomber10\bin\.idea\modules.xml", "XML", 0, 8, 0, 0, 0, 0, 8
"f:\2Study\2Nam2\CS\OOP\Bomberman\bomber10\bin\.idea\runConfigurations.xml", "XML", 0, 10, 0, 0, 0, 0, 10
"f:\2Study\2Nam2\CS\OOP\Bomberman\bomber10\bin\.idea\uiDesigner.xml", "XML", 0, 124, 0, 0, 0, 0, 124
"f:\2Study\2Nam2\CS\OOP\Bomberman\bomber10\bin\.idea\vcs.xml", "XML", 0, 6, 0, 0, 0, 0, 6
"f:\2Study\2Nam2\CS\OOP\Bomberman\bomber10\bin\README.md", "Markdown", 10, 0, 0, 0, 0, 9, 19
"f:\2Study\2Nam2\CS\OOP\Bomberman\bomber10\bin\bomber10.iml", "XML", 0, 12, 0, 0, 0, 0, 12
"f:\2Study\2Nam2\CS\OOP\Bomberman\bomber10\bin\src\Bomberman.class", "Java", 0, 0, 20, 0, 0, 0, 20
"f:\2Study\2Nam2\CS\OOP\Bomberman\bomber10\bin\src\bomb\Bomb.class", "Java", 0, 0, 77, 0, 71, 0, 148
"f:\2Study\2Nam2\CS\OOP\Bomberman\bomber10\bin\src\entities\Bomber.class", "Java", 0, 0, 65, 0, 0, 3, 68
"f:\2Study\2Nam2\CS\OOP\Bomberman\bomber10\bin\src\entities\Entity.class", "Java", 0, 0, 49, 0, 2, 0, 51
"f:\2Study\2Nam2\CS\OOP\Bomberman\bomber10\bin\src\entities\enemy\Balloom.class", "Java", 0, 0, 20, 0, 0, 0, 20
"f:\2Study\2Nam2\CS\OOP\Bomberman\bomber10\bin\src\entities\enemy\EnemyManager.class", "Java", 0, 0, 25, 0, 0, 0, 25
"f:\2Study\2Nam2\CS\OOP\Bomberman\bomber10\bin\src\entities\enemy\Oneal.class", "Java", 0, 0, 15, 0, 0, 0, 15
"f:\2Study\2Nam2\CS\OOP\Bomberman\bomber10\bin\src\game\LEVEL.class", "Java", 0, 0, 14, 0, 3, 0, 17
"f:\2Study\2Nam2\CS\OOP\Bomberman\bomber10\bin\src\graphics\Sprite.class", "Java", 0, 0, 88, 0, 0, 0, 88
"f:\2Study\2Nam2\CS\OOP\Bomberman\bomber10\bin\src\graphics\SpriteSheet.class", "Java", 0, 0, 15, 0, 2, 1, 18
"f:\2Study\2Nam2\CS\OOP\Bomberman\bomber10\bin\src\gui\game\AssetSetter.class", "Java", 0, 0, 34, 0, 0, 0, 34
"f:\2Study\2Nam2\CS\OOP\Bomberman\bomber10\bin\src\gui\game\CollisionChecker.class", "Java", 0, 0, 135, 0, 0, 0, 135
"f:\2Study\2Nam2\CS\OOP\Bomberman\bomber10\bin\src\gui\game\GamePane$1.class", "Java", 0, 0, 17, 0, 0, 0, 17
"f:\2Study\2Nam2\CS\OOP\Bomberman\bomber10\bin\src\gui\game\GamePane.class", "Java", 0, 0, 162, 0, 11, 2, 175
"f:\2Study\2Nam2\CS\OOP\Bomberman\bomber10\bin\src\gui\game\GetImage.class", "Java", 0, 0, 37, 0, 1, 0, 38
"f:\2Study\2Nam2\CS\OOP\Bomberman\bomber10\bin\src\gui\game\KeyHandler$1.class", "Java", 0, 0, 22, 0, 0, 0, 22
"f:\2Study\2Nam2\CS\OOP\Bomberman\bomber10\bin\src\gui\game\KeyHandler$2.class", "Java", 0, 0, 19, 0, 0, 0, 19
"f:\2Study\2Nam2\CS\OOP\Bomberman\bomber10\bin\src\gui\game\KeyHandler.class", "Java", 0, 0, 14, 0, 0, 0, 14
"f:\2Study\2Nam2\CS\OOP\Bomberman\bomber10\bin\src\gui\game\Sound.class", "Java", 0, 0, 34, 0, 0, 0, 34
"f:\2Study\2Nam2\CS\OOP\Bomberman\bomber10\bin\src\gui\game\UI$Message.class", "Java", 0, 0, 9, 0, 0, 0, 9
"f:\2Study\2Nam2\CS\OOP\Bomberman\bomber10\bin\src\gui\game\UI.class", "Java", 0, 0, 82, 0, 5, 1, 88
"f:\2Study\2Nam2\CS\OOP\Bomberman\bomber10\bin\src\gui\model\GameButton.class", "Java", 0, 0, 20, 0, 0, 0, 20
"f:\2Study\2Nam2\CS\OOP\Bomberman\bomber10\bin\src\gui\model\GameLabel.class", "Java", 0, 0, 13, 0, 0, 0, 13
"f:\2Study\2Nam2\CS\OOP\Bomberman\bomber10\bin\src\gui\model\GameLabelButton.class", "Java", 0, 0, 27, 0, 0, 0, 27
"f:\2Study\2Nam2\CS\OOP\Bomberman\bomber10\bin\src\gui\model\GameSubScene.class", "Java", 0, 0, 38, 0, 0, 0, 38
"f:\2Study\2Nam2\CS\OOP\Bomberman\bomber10\bin\src\gui\scenes\level1\Level1.class", "Java", 0, 0, 5, 0, 0, 0, 5
"f:\2Study\2Nam2\CS\OOP\Bomberman\bomber10\bin\src\gui\scenes\level1\level1_map.fxml", "XML", 0, 84, 0, 0, 0, 3, 87
"f:\2Study\2Nam2\CS\OOP\Bomberman\bomber10\bin\src\gui\scenes\loading\loading.fxml", "XML", 0, 20, 0, 0, 0, 3, 23
"f:\2Study\2Nam2\CS\OOP\Bomberman\bomber10\bin\src\gui\scenes\loading\loadingController.class", "Java", 0, 0, 23, 0, 0, 0, 23
"f:\2Study\2Nam2\CS\OOP\Bomberman\bomber10\bin\src\gui\scenes\menu\menu.fxml", "XML", 0, 96, 0, 0, 0, 3, 99
"f:\2Study\2Nam2\CS\OOP\Bomberman\bomber10\bin\src\gui\scenes\menu\menuController.class", "Java", 0, 0, 49, 0, 0, 0, 49
"f:\2Study\2Nam2\CS\OOP\Bomberman\bomber10\bin\src\gui\scenes\scenes.css", "CSS", 0, 0, 0, 53, 2, 14, 69
"f:\2Study\2Nam2\CS\OOP\Bomberman\bomber10\bin\src\object\Bombs.class", "Java", 0, 0, 10, 0, 0, 0, 10
"f:\2Study\2Nam2\CS\OOP\Bomberman\bomber10\bin\src\object\Flames.class", "Java", 0, 0, 8, 0, 0, 0, 8
"f:\2Study\2Nam2\CS\OOP\Bomberman\bomber10\bin\src\object\ObjectManager.class", "Java", 0, 0, 16, 0, 3, 0, 19
"f:\2Study\2Nam2\CS\OOP\Bomberman\bomber10\bin\src\object\Portal.class", "Java", 0, 0, 7, 0, 0, 0, 7
"f:\2Study\2Nam2\CS\OOP\Bomberman\bomber10\bin\src\object\Speed.class", "Java", 0, 0, 10, 0, 0, 0, 10
"f:\2Study\2Nam2\CS\OOP\Bomberman\bomber10\bin\src\tile\Brick.class", "Java", 0, 0, 25, 0, 0, 0, 25
"f:\2Study\2Nam2\CS\OOP\Bomberman\bomber10\bin\src\tile\Grass.class", "Java", 0, 0, 12, 0, 0, 0, 12
"f:\2Study\2Nam2\CS\OOP\Bomberman\bomber10\bin\src\tile\Tile.class", "Java", 0, 0, 19, 0, 0, 0, 19
"f:\2Study\2Nam2\CS\OOP\Bomberman\bomber10\bin\src\tile\TileManager.class", "Java", 0, 0, 34, 0, 0, 1, 35
"f:\2Study\2Nam2\CS\OOP\Bomberman\bomber10\bin\src\tile\Wall.class", "Java", 0, 0, 17, 0, 0, 0, 17
"f:\2Study\2Nam2\CS\OOP\Bomberman\bomber10\bomber10.iml", "XML", 0, 12, 0, 0, 0, 0, 12
"f:\2Study\2Nam2\CS\OOP\Bomberman\bomber10\src\Bomberman.java", "Java", 0, 0, 25, 0, 1, 7, 33
"f:\2Study\2Nam2\CS\OOP\Bomberman\bomber10\src\bomb\Bomb.java", "Java", 0, 0, 290, 0, 12, 34, 336
"f:\2Study\2Nam2\CS\OOP\Bomberman\bomber10\src\entities\Bomber.java", "Java", 0, 0, 268, 0, 24, 30, 322
"f:\2Study\2Nam2\CS\OOP\Bomberman\bomber10\src\entities\Entity.java", "Java", 0, 0, 106, 0, 9, 20, 135
"f:\2Study\2Nam2\CS\OOP\Bomberman\bomber10\src\entities\enemy\Balloom.java", "Java", 0, 0, 56, 0, 0, 13, 69
"f:\2Study\2Nam2\CS\OOP\Bomberman\bomber10\src\entities\enemy\EnemyManager.java", "Java", 0, 0, 61, 0, 1, 11, 73
"f:\2Study\2Nam2\CS\OOP\Bomberman\bomber10\src\entities\enemy\Oneal.java", "Java", 0, 0, 66, 0, 0, 14, 80
"f:\2Study\2Nam2\CS\OOP\Bomberman\bomber10\src\game\LEVEL.java", "Java", 0, 0, 32, 0, 0, 11, 43
"f:\2Study\2Nam2\CS\OOP\Bomberman\bomber10\src\graphics\Sprite.java", "Java", 0, 0, 189, 0, 46, 55, 290
"f:\2Study\2Nam2\CS\OOP\Bomberman\bomber10\src\graphics\SpriteSheet.java", "Java", 0, 0, 30, 0, 6, 7, 43
"f:\2Study\2Nam2\CS\OOP\Bomberman\bomber10\src\gui\game\AssetSetter.java", "Java", 0, 0, 41, 0, 0, 6, 47
"f:\2Study\2Nam2\CS\OOP\Bomberman\bomber10\src\gui\game\CollisionChecker.java", "Java", 0, 0, 278, 0, 8, 54, 340
"f:\2Study\2Nam2\CS\OOP\Bomberman\bomber10\src\gui\game\GamePane.java", "Java", 0, 0, 275, 0, 54, 61, 390
"f:\2Study\2Nam2\CS\OOP\Bomberman\bomber10\src\gui\game\GetImage.java", "Java", 0, 0, 104, 0, 16, 17, 137
"f:\2Study\2Nam2\CS\OOP\Bomberman\bomber10\src\gui\game\KeyHandler.java", "Java", 0, 0, 48, 0, 5, 7, 60
"f:\2Study\2Nam2\CS\OOP\Bomberman\bomber10\src\gui\game\Sound.java", "Java", 0, 0, 41, 0, 0, 13, 54
"f:\2Study\2Nam2\CS\OOP\Bomberman\bomber10\src\gui\game\UI.java", "Java", 0, 0, 189, 0, 12, 29, 230
"f:\2Study\2Nam2\CS\OOP\Bomberman\bomber10\src\gui\model\GameButton.java", "Java", 0, 0, 19, 0, 2, 5, 26
"f:\2Study\2Nam2\CS\OOP\Bomberman\bomber10\src\gui\model\GameLabel.java", "Java", 0, 0, 14, 0, 0, 4, 18
"f:\2Study\2Nam2\CS\OOP\Bomberman\bomber10\src\gui\model\GameLabelButton.java", "Java", 0, 0, 24, 0, 0, 7, 31
"f:\2Study\2Nam2\CS\OOP\Bomberman\bomber10\src\gui\model\GameSubScene.java", "Java", 0, 0, 42, 0, 2, 12, 56
"f:\2Study\2Nam2\CS\OOP\Bomberman\bomber10\src\gui\scenes\level1\Level1.java", "Java", 0, 0, 3, 0, 0, 3, 6
"f:\2Study\2Nam2\CS\OOP\Bomberman\bomber10\src\gui\scenes\level1\level1Controller.java", "Java", 0, 0, 0, 0, 77, 18, 95
"f:\2Study\2Nam2\CS\OOP\Bomberman\bomber10\src\gui\scenes\level1\level1_map.fxml", "XML", 0, 84, 0, 0, 0, 3, 87
"f:\2Study\2Nam2\CS\OOP\Bomberman\bomber10\src\gui\scenes\loading\loading.fxml", "XML", 0, 20, 0, 0, 0, 3, 23
"f:\2Study\2Nam2\CS\OOP\Bomberman\bomber10\src\gui\scenes\loading\loadingController.java", "Java", 0, 0, 38, 0, 2, 9, 49
"f:\2Study\2Nam2\CS\OOP\Bomberman\bomber10\src\gui\scenes\menu\menu.fxml", "XML", 0, 96, 0, 0, 0, 3, 99
"f:\2Study\2Nam2\CS\OOP\Bomberman\bomber10\src\gui\scenes\menu\menuController.java", "Java", 0, 0, 87, 0, 9, 23, 119
"f:\2Study\2Nam2\CS\OOP\Bomberman\bomber10\src\gui\scenes\scenes.css", "CSS", 0, 0, 0, 53, 2, 14, 69
"f:\2Study\2Nam2\CS\OOP\Bomberman\bomber10\src\object\Bombs.java", "Java", 0, 0, 14, 0, 0, 4, 18
"f:\2Study\2Nam2\CS\OOP\Bomberman\bomber10\src\object\Flames.java", "Java", 0, 0, 14, 0, 0, 3, 17
"f:\2Study\2Nam2\CS\OOP\Bomberman\bomber10\src\object\ObjectManager.java", "Java", 0, 0, 59, 0, 7, 10, 76
"f:\2Study\2Nam2\CS\OOP\Bomberman\bomber10\src\object\Portal.java", "Java", 0, 0, 15, 0, 0, 4, 19
"f:\2Study\2Nam2\CS\OOP\Bomberman\bomber10\src\object\Speed.java", "Java", 0, 0, 14, 0, 0, 4, 18
"f:\2Study\2Nam2\CS\OOP\Bomberman\bomber10\src\tile\Brick.java", "Java", 0, 0, 52, 0, 0, 8, 60
"f:\2Study\2Nam2\CS\OOP\Bomberman\bomber10\src\tile\Grass.java", "Java", 0, 0, 9, 0, 0, 5, 14
"f:\2Study\2Nam2\CS\OOP\Bomberman\bomber10\src\tile\Tile.java", "Java", 0, 0, 27, 0, 0, 10, 37
"f:\2Study\2Nam2\CS\OOP\Bomberman\bomber10\src\tile\TileManager.java", "Java", 0, 0, 82, 0, 3, 13, 98
"f:\2Study\2Nam2\CS\OOP\Bomberman\bomber10\src\tile\Wall.java", "Java", 0, 0, 11, 0, 0, 5, 16
"Total", "-", 20, 752, 3909, 106, 398, 608, 5793